0
xxxxxxxxxxxxxxxxxxxxxx
x   x  xxx xx        x
x     x     x xxxx xxx
x x   xxx  xxx xxx    
xx   xx x xx  xxxxxx x
x          xx xxx  x x
x x xx  x      xx  x x
x x xx xx  x x  xx   x
x x x      x x  x x  x
xxS x x  x x x     x x
xxxxxxxxxxxxxxxxxxxxxx